0000030000000300
1111211111111121
0000200000030020
1111111211121111
0000000200020000
1111111211121111
0000000200020000
1111111111111111