0000030000000000
1111211111111121
0000200000030020
1111111121112111
0000000020002000
1111111111121112
0000000030020002
1111111111111111